31 13
WWWWWWWWWWWWWWWWWWWWWWWWWWWWWWW
WP# W#   #     W #  WB #   # #W
W W# W##W #      WW ## # #  W W
W  #W     # ## ##  W #   B#   W
W##      #   #  #  W   W   W  W
W#####WW  #B# #   W# ##W#W W##W
W # # ## ##  #   W  W## #W# D W
W   ## #   # ###  E W# #  # WWW
W##  ## # W ##W  #  #W #      W
WW    #  ####WW  W #W #W   # EW
W   E  WWD WW#    W   W##W  # W
WW # W  #   #W # #W ### ###W WW
WWWWWWWWWWWWWWWWWWWWWWWWWWWWWWW