1 31 13
WWWWWWWWWWWWWWWWWWWWWWWWWWWWWWW
WP     ## #    #   #  # # #   W
W W W W#W W W#W#W W W W#W#W#W W
W   #     ###  #      #   # # W
W W W W W W#W W W#W#W W W W W#W
W          W ##B #  #  E     BW
W W W W W W W W W W#WBW#W W W W
W#  #      #  #      #        W
W W W W W#W W W W#W#W W W W W W
W#    ##  #       #           W
W W#W W W W W W W#W W W W W W W
W           #D  #  #          W
WWWWWWWWWWWWWWWWWWWWWWWWWWWWWWW


Disclaimer:
This file was taken directly from another github project on bomberman https://github.com/carlosflorencio/bomberman, and is used for testing.