31 13
WWWWWWWWWWWWWWWWWWWWWWWWWWWWWWW
WP W#W#W#B WWWW               W
W#  #      #  #      #        W
W W W W W#W W W W#W#W W W W W W
W#    ##  #       #           W
W W#W W WXW W W W#W W  #  W W W
W          W ##  #  #         W
W W W W # #WW W W W#W W#W W W W
W#    ##  #       #           W
W W#W W W W W W W#W W W W W W W
W           #   #  #          W
W W#W W W W W W W#W W W W W W W
WWWWWWWWWWWWWWWWWWWWWWWWWWWWWWW