WWWWWWWWWWWWWWWWWWWW
WOOOOOOOOOOOOOOOOOOW
WOOOOOOOOOOOOOOOOOOW
WOOOOOOOOOOOOOOOOOOW
WOOOPOOOOOOOOOOOOOOW
WOOOOOOOOOOOOOOOOOOW
WOOOOOOOOOOOOOOOOOOW
WOOOOOOOOOOOOOOOOOOW
WOOOOOOOOOOOOOOOOOOW
WOOOOOOOWWWOOOOOOOOW
WOOOOOOOOOOOOOOOOOOW
WOOOOOOOWWWOOOOOOOOW
WOOOOOOOOWOOOOOOOOOW
WOOOOOOOOWOOOOOOOOOW
WOOOOOOOWWWOOOOOOOOW
WOOOOOOOOOOOOOOOOOOW
WOOOOOOOOOOOOOOOOOOW
WOOOOOOOOOOOOOOOOOOW
WOOOOOOOOOOOOOOOOOOW
WWWWWWWWWWWWWWWWWWWW