WWWWWWWWWW
WOOOOOOOOW
WOOOOOOOOW
WOOOOOOOOW
WOOOPOOOOW
WOOOOOOOOW
WOOOOOOOOW
WOOOOOOOOW
WOOOOOOOOW
WWWWWWWWWW