WWWWWWWWWWWWWWWWWWWW
WOOOOOOOOOOOOOOOOOOW
WOOOOOOOOOOOOOOOOOOW
WOOOOOOOOOOOOOOOOOOW
WOOOPOOOOOOOOOOOOOOW
WOOOOOOOOOOOOOOOOOOW
WOOOOOOOOOOOOOOOOOOW
WOOOOOOOOOOOOOOOOOOW
WOOOOOOOOOOOOOOOOOOW
WOOOOOOOOOOOOOOOOOOW
WOOOOOOOOOOOOOOOOOOW
WOOOOOOOOOOOOOOOOOOW
WOOOOOOOOOOOOOOOOOOW
WOOOOOOOOOOOOOOOOOOW
WOOOOOOOOOOOOOOOOOOW
WOOOOOOOOOOOOOOOOOOW
WOOOOOOOOOOOOOOOOOOW
WOOOOOOOOOOOOOOOOOOW
WOOOOOOOOOOOOOOOOOOW
WWWWWWWWWWWWWWWWWWWW